01,01,01,01,03,03,03,01,01,01,01,01,01,01,03,03,01,01,01,01
01,01,03,03,01,01,01,01,03,03,01,01,01,01,01,01,03,01,01,01
01,03,01,01,01,01,02,02,03,01,01,01,01,01,01,01,01,03,01,01
03,01,04,05,06,02,02,02,03,01,01,13,14,14,15,01,01,03,01,01
01,01,07,08,05,05,06,03,01,01,01,16,17,17,18,01,01,03,03,03
01,02,07,08,08,08,09,03,02,02,02,16,17,17,18,03,03,03,01,01
01,02,07,08,08,08,09,03,01,03,03,16,17,17,18,01,02,03,01,01
02,01,07,08,08,08,09,03,03,01,02,16,17,17,18,02,03,01,01,01
03,03,10,11,11,11,12,03,01,02,01,16,17,17,18,03,03,01,02,02
01,01,01,01,01,02,01,03,02,01,01,16,17,17,18,02,01,02,01,01
01,01,01,01,01,02,02,03,01,01,01,16,17,17,18,02,02,01,01,01
02,02,22,22,22,22,02,03,22,02,02,19,20,20,21,02,01,01,01,01
01,01,22,01,01,22,01,01,22,01,01,03,01,01,01,02,01,01,01,01
03,03,22,03,03,22,03,03,22,03,03,03,03,03,03,03,03,03,03,03
01,01,22,01,01,01,01,01,22,01,01,01,01,01,01,02,02,01,03,03
03,03,22,01,01,01,01,01,22,01,01,01,01,01,03,03,03,03,01,01
01,01,22,03,03,03,03,03,22,03,03,03,03,03,01,01,02,02,01,01
01,01,22,22,22,22,22,22,22,01,01,01,01,01,01,01,01,02,02,02
01,01,01,01,01,01,01,01,01,01,01,01,01,01,01,01,01,01,01,01
01,01,01,01,01,01,01,01,01,01,01,01,01,01,01,01,01,01,01,01