1,1,1,1,3,3,3,1,1,1,1,1,1,1,3,3,1,1,1,1
1,1,3,3,1,1,1,1,3,3,1,1,1,1,1,1,3,1,1,1
1,3,1,1,1,1,2,2,3,1,1,1,1,1,1,1,1,3,1,1
3,1,4,5,6,2,2,2,3,1,1,13,14,14,15,1,1,3,1,1
1,1,7,8,5,5,6,3,1,1,1,16,17,17,18,1,1,3,3,3
1,2,7,8,8,8,9,3,2,2,2,16,17,17,18,3,3,3,1,1
1,2,7,8,8,8,9,3,1,3,3,16,17,17,18,1,2,3,1,1
2,1,7,8,8,8,9,3,3,1,2,16,17,17,18,2,3,1,1,1
3,3,10,11,11,11,12,3,1,2,1,16,17,17,18,3,3,1,2,2
1,1,1,1,1,2,1,3,2,1,1,16,17,17,18,2,1,2,1,1
1,1,1,1,1,2,2,3,1,1,1,16,17,17,18,2,2,1,1,1
2,2,22,22,22,22,2,3,22,2,2,19,20,20,21,2,1,1,1,1
1,1,22,1,1,22,1,1,22,1,1,3,1,1,1,2,1,1,1,1
3,3,22,3,3,22,3,3,22,3,3,3,3,3,3,3,3,3,3,3
1,1,22,1,1,1,1,1,22,1,1,1,1,1,1,2,2,1,3,3
3,3,22,1,1,1,1,1,22,1,1,1,1,1,3,3,3,3,1,1
1,1,22,3,3,3,3,3,22,3,3,3,3,3,1,1,2,2,1,1
1,1,22,22,22,22,22,22,22,1,1,1,1,1,1,1,1,2,2,2
1,1,1,1,1,1,1,1,1,1,1,1,1,1,1,1,1,1,1,1
1,1,1,1,1,1,1,1,1,1,1,1,1,1,1,1,1,1,1,